    PROGRAM -> STATEMENT|&
    STATEMENT -> VARDECL; | ATRIBSTAT; | PRINTSTAT; | READSTAT; | RETURNSTAT;
                | IFSTAT; | FORSTAT; | {STATELIST} | break; | ;
    
    VARDECL: A ident B
    
    A: int | float | string
    B: [int_constant] | [int_constant]B | &

    ATRIBSTAT: LVALUE = H
    H: EXPRESSION | ALLOCEXPRESSION

    PRINTSTAT: print EXPRESSION
    READSTAT: read LVALUE
    RETURNSTAT: return

    IFSTAT: if(EXPRESSION) STATEMENT I
    I: else STATEMENT | &

    FORSTAT: for(ATRIBSTAT; NUMEXPRESSION; ATRIBSTAT) STATEMENT

    STATELIST: STATEMENT J
    J: STATELIST | &

    ALLOCEXPRESSION: new A C
    C: [EXPRESSION]K
    K: C | &

    EXPRESSION: NUMEXPRESSION L
    D: < | > | <= | >= | == | !=
    L: D NUMEXPRESSION | &
    
    NUMEXPRESSION: TERM N

    N: MAISOUMENOS M | &
    MAISOUMENOS: + | -
    M: TERM | TERM N
    
    TERM: UNARYEXPR E
    E: F UNARYEXPR O | &
    F: * | \ | %
    O: E | &

    UNARYEXPR: MAISOUMENOS FACTOR | FACTOR

    FACTOR: int_constant | float_constant | string_constant | null | LVALUE | (EXPRESSION)

    LVALUE: ident G
    G: [EXPRESSION] P | &
    P: G | &